AF	AF	Afghanistan
AL	AL	Albania
AG	DZ	Algeria
AN	AD	Andorra
AO	AO	Angola
AV	AI	Anguilla
AC	AG	Antigua And Barbuda
AR	AR	Argentina
AM	AM	Armenia
AA	AW	Aruba
AT	AU	Ashmore And Cartier Islands
AS	AU	Australia
AU	AT	Austria
AJ	AZ	Azerbaijan
BF	BS	Bahamas, The
BA	BH	Bahrain
BG	BG	Bangladesh
BB	BB	Barbados
BS	TF	Bassas Da India
BO	BY	Belarus
BE	BE	Belgium
BH	BZ	Belize
BN	BJ	Benin
BD	BM	Bermuda
BT	BT	Bhutan
BL	BO	Bolivia
BK	BA	Bosnia And Herzegovina
BC	BW	Botswana
BV	BV	Bouvet Island
BR	BR	Brazil
IO	IO	British Indian Ocean Territory
VI	VG	British Virgin Islands
BX	BN	Brunei
BU	BG	Bulgaria
UV	BF	Burkina Faso
BM	MM	Burma
BY	BI	Burundi
CB	KH	Cambodia
CM	CM	Cameroon
CA	CA	Canada
CV	CV	Cape Verde
CJ	KY	Cayman Islands
CT	CF	Central African Republic
CD	TD	Chad
CI	CL	Chile
CH	CN	China
KT	CX	Christmas Island
IP	PF	Clipperton Island
CK	CC	Cocos (Keeling)  Islands
CO	CO	Colombia
CN	KM	Comoros
CF	CG	Congo
CG	CD	Congo, Democratic Republic Of The
CW	CK	Cook Islands
CR	AU	Coral Sea Islands
CS	CR	Costa Rica
IV	CI	Cote D'Ivoire
HR	HR	Croatia
CU	CU	Cuba
CY	CY	Cyprus
EZ	CZ	Czech Republic
DA	DK	Denmark
DJ	DJ	Djibouti
DO	DM	Dominica
DR	DO	Dominican Republic
TT	TL	East Timor
EC	EC	Ecuador
EG	EG	Egypt
ES	SV	El Salvador
EK	GQ	Equatorial Guinea
ER	ER	Eritrea
EN	EE	Estonia
ET	ET	Ethiopia
EU	TF	Europa Island
FK	FK	Falkland Islands (Islas Malvinas)
FO	FO	Faroe Islands
FJ	FJ	Fiji
FI	FI	Finland
FR	FR	France
FG	GF	French Guiana
FP	PF	French Polynesia
FS	TF	French Southern And Antarctic Lands
GB	GA	Gabon
GA	GM	Gambia, The
GZ	PS	Gaza Strip
GG	GE	Georgia
GM	DE	Germany
GH	GH	Ghana
GI	GI	Gibraltar
GO	TF	Glorioso Islands
GR	GR	Greece
GL	GL	Greenland
GJ	GD	Grenada
GP	GP	Guadeloupe
GT	GT	Guatemala
GK	GK	Guernsey
GV	GN	Guinea
PU	GW	Guinea-Bissau
GY	GY	Guyana
HA	HT	Haiti
HM	HM	Heard Island And Mcdonald Islands
HO	HN	Honduras
HK	HK	Hong Kong
HU	HU	Hungary
IC	IS	Iceland
IN	IN	India
ID	ID	Indonesia
IR	IR	Iran
IZ	IQ	Iraq
EI	IE	Ireland
IM	IM	Isle Of Man
IS	IL	Israel
IT	IT	Italy
JM	JM	Jamaica
JN	SJ	Jan Mayen
JA	JA	Japan
JE	JE	Jersey
JO	JO	Jordan
JU	TF	Juan De Nova Island
KZ	KZ	Kazakhstan
KE	KE	Kenya
KR	KI	Kiribati
KU	KW	Kuwait
KG	KG	Kyrgyzstan
LA	LA	Laos
LG	LV	Latvia
LE	LB	Lebanon
LT	LS	Lesotho
LI	LR	Liberia
LY	LY	Libya
LS	LI	Liechtenstein
LH	LT	Lithuania
LU	LU	Luxembourg
MC	MO	Macau
MK	MK	Macedonia
MA	MG	Madagascar
MI	MW	Malawi
MY	MY	Malaysia
MV	MV	Maldives
ML	ML	Mali
MT	MT	Malta
RM	MH	Marshall Islands
MB	MQ	Martinique
MR	MR	Mauritania
MP	MU	Mauritius
MF	YT	Mayotte
MX	MX	Mexico
FM	FM	Micronesia, Federated States Of
MD	MD	Moldova
MN	MC	Monaco
MG	MN	Mongolia
MJ	ME	Montenegro
MH	MS	Montserrat
MO	MA	Morocco
MZ	MZ	Mozambique
WA	NA	Namibia
NR	NR	Nauru
NP	NP	Nepal
NL	NL	Netherlands
NT	AN	Netherlands Antilles
NC	NC	New Caledonia
NZ	NZ	New Zealand
NU	NI	Nicaragua
NG	NE	Niger
NI	NG	Nigeria
NE	NU	Niue
NF	NF	Norfolk Island
KN	KP	North Korea
NO	NO	Norway
OS		Oceans, marine features
MU	OM	Oman
PK	PK	Pakistan
PS	PW	Palau
PM	PA	Panama
PP	PG	Papua New Guinea
PF		Paracel Islands
PA	PY	Paraguay
PE	PE	Peru
RP	PH	Philippines
PC	PN	Pitcairn Islands
PL	PL	Poland
PO	PT	Portugal
QA	QA	Qatar
RE	RE	Reunion
RO	RO	Romania
RS	RU	Russia
RW	RW	Rwanda
SH	SH	Saint Helena
SC	KN	Saint Kitts And Nevis
ST	LC	Saint Lucia
SB	PM	Saint Pierre And Miquelon
VC	VC	Saint Vincent And The Grenadines
WS	WS	Samoa
SM	SM	San Marino
TP	ST	Sao Tome And Principe
SA	SA	Saudi Arabia
SG	SN	Senegal
RB	RS	Serbia
SE	SC	Seychelles
SL	SL	Sierra Leone
SN	SG	Singapore
LO	SK	Slovakia
SI	SI	Slovenia
BP	SB	Solomon Islands
SO	SO	Somalia
SF	ZA	South Africa
SX	GS	South Georgia And The South Sandwich Islands
KS	KR	South Korea
SP	ES	Spain
PG		Spratly Islands
CE	LK	Sri Lanka
SU	SD	Sudan
NS	SR	Suriname
SV	SJ	Svalbard
WZ	SZ	Swaziland
SW	SE	Sweden
SZ	CH	Switzerland
SY	SY	Syria
TW	TW	Taiwan
TI	TJ	Tajikistan
TZ	TZ	Tanzania
TH	TH	Thailand
TO	TG	Togo
TL	TK	Tokelau
TN	TO	Tonga
TD	TT	Trinidad And Tobago
TE	TF	Tromelin Island
TS	TN	Tunisia
TU	TR	Turkey
TX	TM	Turkmenistan
TK	TC	Turks And Caicos Islands
TV	TV	Tuvalu
UG	UG	Uganda
UP	UA	Ukraine
UF		Undersea Features
AE	AE	United Arab Emirates
UK	GB	United Kingdom
US-AL	US	United States - Alabama
US-AK	US	United States - Alaska
US-AS	US	United States - American Samoa
US-AZ	US	United States - Arizona
US-AR	US	United States - Arkansas
US-CA	US	United States - California
US-CO	US	United States - Colorado
US-CT	US	United States - Connecticut
US-DE	US	United States - Delaware
US-DC	US	United States - District of Columbia
US-FL	US	United States - Florida
US-GA	US	United States - Georgia
US-GU	US	United States - Guam
US-HI	US	United States - Hawaii
US-ID	US	United States - Idaho
US-IL	US	United States - Illinois
US-IN	US	United States - Indiana
US-IA	US	United States - Iowa
US-KS	US	United States - Kansas
US-KY	US	United States - Kentucky
US-LA	US	United States - Louisiana
US-ME	US	United States - Maine
US-MH	US	United States - Marshall Island
US-MD	US	United States - Maryland
US-MA	US	United States - Massachusetts
US-MI	US	United States - Michigan
US-FM	US	United States - Micronesia
US-MN	US	United States - Minnesota
US-MS	US	United States - Mississippi
US-MO	US	United States - Missouri
US-MT	US	United States - Montana
US-NE	US	United States - Nebraska
US-NV	US	United States - Nevada
US-NH	US	United States - New Hampshire
US-NJ	US	United States - New Jersey
US-NM	US	United States - New Mexico
US-NY	US	United States - New York
US-NC	US	United States - North Carolina
US-ND	US	United States - North Dakota
US-MP	US	United States - Northern Marianas
US-OH	US	United States - Ohio
US-OK	US	United States - Oklahoma
US-OR	US	United States - Oregon
US-PW	US	United States - Palau
US-PA	US	United States - Pennsylvania
US-PR	US	United States - Puerto Rico
US-RI	US	United States - Rhode Island
US-SC	US	United States - South Carolina
US-SD	US	United States - South Dakota
US-TN	US	United States - Tennessee
US-TX	US	United States - Texas
US-UM	UM	United States - US Minor Islands
US-UT	US	United States - Utah
US-VT	US	United States - Vermont
US-VA	US	United States - Virginia
US-VI	US	United States - Virgin Islands
US-WA	US	United States - Washington
US-WV	US	United States - West Virginia
US-WI	US	United States - Wisconsin
US-WY	US	United States - Wyoming
UY	UY	Uruguay
UZ	UZ	Uzbekistan
NH	VU	Vanuatu
VT	VA	Vatican City
VE	VE	Venezuela
VM	VN	Vietnam
WF	WF	Wallis And Futuna
WE	PS	West Bank
WI	EH	Western Sahara
YM	YE	Yemen
ZA	ZM	Zambia
ZI	ZW	Zimbabwe
